defteam,week,season,def_plays,expl_rush_allowed,expl_pass_allowed,expl_total_allowed,expl_rate_allowed,chunk20_allowed,chunk20_rate
ARI,1,2024,57,2,5,7,0.12280701754385964,3,0.05263157894736842
ATL,1,2024,66,2,2,4,0.06060606060606061,3,0.045454545454545456
BAL,1,2024,49,1,8,9,0.1836734693877551,6,0.12244897959183673
BUF,1,2024,59,4,2,6,0.1016949152542373,4,0.06779661016949153
CAR,1,2024,62,5,6,11,0.1774193548387097,2,0.03225806451612903
CHI,1,2024,61,5,3,8,0.13114754098360656,3,0.04918032786885246
CIN,1,2024,61,5,3,8,0.13114754098360656,0,0.0
CLE,1,2024,59,3,4,7,0.11864406779661017,2,0.03389830508474576
DAL,1,2024,70,2,3,5,0.07142857142857142,2,0.02857142857142857
DEN,1,2024,57,4,3,7,0.12280701754385964,3,0.05263157894736842
DET,1,2024,74,1,6,7,0.0945945945945946,4,0.05405405405405406
GB,1,2024,73,3,6,9,0.1232876712328767,5,0.0684931506849315
HOU,1,2024,43,3,3,6,0.13953488372093023,3,0.06976744186046512
IND,1,2024,74,6,4,10,0.13513513513513514,2,0.02702702702702703
JAX,1,2024,65,2,6,8,0.12307692307692308,5,0.07692307692307693
KC,1,2024,74,5,7,12,0.16216216216216217,2,0.02702702702702703
LA,1,2024,61,3,4,7,0.11475409836065574,4,0.06557377049180328
LAC,1,2024,59,1,6,7,0.11864406779661017,4,0.06779661016949153
LV,1,2024,51,4,2,6,0.11764705882352941,3,0.058823529411764705
MIA,1,2024,50,4,5,9,0.18,5,0.1
MIN,1,2024,68,1,4,5,0.07352941176470588,2,0.029411764705882353
NE,1,2024,48,1,1,2,0.041666666666666664,1,0.020833333333333332
NO,1,2024,55,0,3,3,0.05454545454545454,2,0.03636363636363636
NYG,1,2024,50,5,4,9,0.18,3,0.06
NYJ,1,2024,69,6,6,12,0.17391304347826086,5,0.07246376811594203
PHI,1,2024,58,5,5,10,0.1724137931034483,7,0.1206896551724138
PIT,1,2024,49,3,3,6,0.12244897959183673,1,0.02040816326530612
SEA,1,2024,69,3,2,5,0.07246376811594203,2,0.028985507246376812
SF,1,2024,48,1,3,4,0.08333333333333333,2,0.041666666666666664
TB,1,2024,55,4,3,7,0.12727272727272726,2,0.03636363636363636
TEN,1,2024,51,3,0,3,0.058823529411764705,1,0.0196078431372549
WAS,1,2024,59,4,7,11,0.1864406779661017,5,0.0847457627118644
ARI,2,2024,52,0,5,5,0.09615384615384616,4,0.07692307692307693
ATL,2,2024,67,6,4,10,0.14925373134328357,1,0.014925373134328358
BAL,2,2024,59,0,6,6,0.1016949152542373,5,0.0847457627118644
BUF,2,2024,75,6,6,12,0.16,1,0.013333333333333334
CAR,2,2024,62,5,3,8,0.12903225806451613,2,0.03225806451612903
CHI,2,2024,60,3,9,12,0.2,3,0.05
CIN,2,2024,59,2,2,4,0.06779661016949153,1,0.01694915254237288
CLE,2,2024,54,4,5,9,0.16666666666666666,7,0.12962962962962962
DAL,2,2024,53,5,5,10,0.18867924528301888,3,0.05660377358490566
DEN,2,2024,58,4,1,5,0.08620689655172414,0,0.0
DET,2,2024,46,3,7,10,0.21739130434782608,2,0.043478260869565216
GB,2,2024,52,7,5,12,0.23076923076923078,4,0.07692307692307693
HOU,2,2024,66,2,3,5,0.07575757575757576,2,0.030303030303030304
IND,2,2024,67,9,3,12,0.1791044776119403,3,0.04477611940298507
JAX,2,2024,65,2,3,5,0.07692307692307693,4,0.06153846153846154
KC,2,2024,61,1,3,4,0.06557377049180328,2,0.03278688524590164
LA,2,2024,62,7,8,15,0.24193548387096775,8,0.12903225806451613
LAC,2,2024,46,2,0,2,0.043478260869565216,1,0.021739130434782608
LV,2,2024,61,3,7,10,0.16393442622950818,2,0.03278688524590164
MIA,2,2024,42,2,3,5,0.11904761904761904,3,0.07142857142857142
MIN,2,2024,67,3,7,10,0.14925373134328357,6,0.08955223880597014
NE,2,2024,64,0,6,6,0.09375,2,0.03125
NO,2,2024,65,0,5,5,0.07692307692307693,2,0.03076923076923077
NYG,2,2024,67,8,6,14,0.208955223880597,6,0.08955223880597014
NYJ,2,2024,60,5,5,10,0.16666666666666666,3,0.05
PHI,2,2024,56,6,5,11,0.19642857142857142,3,0.05357142857142857
PIT,2,2024,56,2,5,7,0.125,4,0.07142857142857142
SEA,2,2024,66,4,2,6,0.09090909090909091,2,0.030303030303030304
SF,2,2024,51,5,6,11,0.21568627450980393,3,0.058823529411764705
TB,2,2024,82,4,8,12,0.14634146341463414,4,0.04878048780487805
TEN,2,2024,55,2,4,6,0.10909090909090909,4,0.07272727272727272
WAS,2,2024,51,4,4,8,0.1568627450980392,4,0.0784313725490196
ARI,3,2024,66,6,5,11,0.16666666666666666,3,0.045454545454545456
ATL,3,2024,69,1,3,4,0.057971014492753624,1,0.014492753623188406
BAL,3,2024,70,0,14,14,0.2,6,0.08571428571428572
BUF,3,2024,68,3,3,6,0.08823529411764706,2,0.029411764705882353
CAR,3,2024,59,1,6,7,0.11864406779661017,3,0.05084745762711865
CHI,3,2024,51,5,3,8,0.1568627450980392,5,0.09803921568627451
CIN,3,2024,55,1,4,5,0.09090909090909091,4,0.07272727272727272
CLE,3,2024,66,2,4,6,0.09090909090909091,4,0.06060606060606061
DAL,3,2024,58,10,3,13,0.22413793103448276,5,0.08620689655172414
DEN,3,2024,56,2,0,2,0.03571428571428571,1,0.017857142857142856
DET,3,2024,53,2,3,5,0.09433962264150944,2,0.03773584905660377
GB,3,2024,53,0,7,7,0.1320754716981132,4,0.07547169811320754
HOU,3,2024,59,1,4,5,0.0847457627118644,4,0.06779661016949153
IND,3,2024,83,0,7,7,0.08433734939759036,3,0.03614457831325301
JAX,3,2024,59,5,7,12,0.2033898305084746,3,0.05084745762711865
KC,3,2024,55,3,5,8,0.14545454545454545,3,0.05454545454545454
LA,3,2024,65,3,6,9,0.13846153846153847,4,0.06153846153846154
LAC,3,2024,63,5,5,10,0.15873015873015872,5,0.07936507936507936
LV,3,2024,68,3,9,12,0.17647058823529413,6,0.08823529411764706
MIA,3,2024,58,5,8,13,0.22413793103448276,2,0.034482758620689655
MIN,3,2024,62,0,9,9,0.14516129032258066,2,0.03225806451612903
NE,3,2024,70,4,6,10,0.14285714285714285,4,0.05714285714285714
NO,3,2024,64,5,6,11,0.171875,8,0.125
NYG,3,2024,62,4,3,7,0.11290322580645161,3,0.04838709677419355
NYJ,3,2024,48,2,3,5,0.10416666666666667,1,0.020833333333333332
PHI,3,2024,54,1,3,4,0.07407407407407407,2,0.037037037037037035
PIT,3,2024,45,1,4,5,0.1111111111111111,1,0.022222222222222223
SEA,3,2024,56,2,4,6,0.10714285714285714,2,0.03571428571428571
SF,3,2024,55,1,5,6,0.10909090909090909,3,0.05454545454545454
TB,3,2024,63,2,4,6,0.09523809523809523,4,0.06349206349206349
TEN,3,2024,59,5,6,11,0.1864406779661017,7,0.11864406779661017
WAS,3,2024,60,6,7,13,0.21666666666666667,3,0.05
ARI,4,2024,67,5,4,9,0.13432835820895522,2,0.029850746268656716
ATL,4,2024,70,4,4,8,0.11428571428571428,1,0.014285714285714285
BAL,4,2024,57,0,4,4,0.07017543859649122,4,0.07017543859649122
BUF,4,2024,54,6,5,11,0.2037037037037037,5,0.09259259259259259
CAR,4,2024,62,5,3,8,0.12903225806451613,4,0.06451612903225806
CHI,4,2024,57,3,7,10,0.17543859649122806,2,0.03508771929824561
CIN,4,2024,69,3,4,7,0.10144927536231885,3,0.043478260869565216
CLE,4,2024,53,7,1,8,0.1509433962264151,1,0.018867924528301886
DAL,4,2024,64,0,6,6,0.09375,2,0.03125
DEN,4,2024,70,1,5,6,0.08571428571428572,5,0.07142857142857142
DET,4,2024,78,7,8,15,0.19230769230769232,7,0.08974358974358974
GB,4,2024,61,4,6,10,0.16393442622950818,4,0.06557377049180328
HOU,4,2024,57,5,4,9,0.15789473684210525,4,0.07017543859649122
IND,4,2024,67,5,6,11,0.16417910447761194,5,0.07462686567164178
JAX,4,2024,68,2,10,12,0.17647058823529413,7,0.10294117647058823
KC,4,2024,53,1,4,5,0.09433962264150944,3,0.05660377358490566
LA,4,2024,52,1,2,3,0.057692307692307696,3,0.057692307692307696
LAC,4,2024,55,2,6,8,0.14545454545454545,3,0.05454545454545454
LV,4,2024,57,1,2,3,0.05263157894736842,1,0.017543859649122806
MIA,4,2024,61,3,4,7,0.11475409836065574,2,0.03278688524590164
MIN,4,2024,74,2,10,12,0.16216216216216217,7,0.0945945945945946
NE,4,2024,59,4,6,10,0.1694915254237288,7,0.11864406779661017
NO,4,2024,51,3,5,8,0.1568627450980392,3,0.058823529411764705
NYG,4,2024,50,1,4,5,0.1,1,0.02
NYJ,4,2024,54,4,2,6,0.1111111111111111,2,0.037037037037037035
PHI,4,2024,73,4,10,14,0.1917808219178082,4,0.0547945205479452
PIT,4,2024,63,5,6,11,0.1746031746031746,5,0.07936507936507936
SEA,4,2024,48,3,6,9,0.1875,6,0.125
SF,4,2024,62,1,2,3,0.04838709677419355,2,0.03225806451612903
TB,4,2024,55,1,3,4,0.07272727272727272,3,0.05454545454545454
TEN,4,2024,54,4,2,6,0.1111111111111111,2,0.037037037037037035
WAS,4,2024,58,7,2,9,0.15517241379310345,2,0.034482758620689655
ARI,5,2024,63,5,5,10,0.15873015873015872,4,0.06349206349206349
ATL,5,2024,50,4,6,10,0.2,4,0.08
BAL,5,2024,65,2,8,10,0.15384615384615385,3,0.046153846153846156
BUF,5,2024,67,3,8,11,0.16417910447761194,2,0.029850746268656716
CAR,5,2024,66,3,9,12,0.18181818181818182,6,0.09090909090909091
CHI,5,2024,58,2,6,8,0.13793103448275862,5,0.08620689655172414
CIN,5,2024,76,3,10,13,0.17105263157894737,5,0.06578947368421052
CLE,5,2024,65,7,5,12,0.18461538461538463,8,0.12307692307692308
DAL,5,2024,57,0,5,5,0.08771929824561403,2,0.03508771929824561
DEN,5,2024,65,3,4,7,0.1076923076923077,3,0.046153846153846156
GB,5,2024,76,2,5,7,0.09210526315789473,3,0.039473684210526314
HOU,5,2024,59,7,4,11,0.1864406779661017,4,0.06779661016949153
IND,5,2024,57,2,4,6,0.10526315789473684,5,0.08771929824561403
JAX,5,2024,68,3,9,12,0.17647058823529413,7,0.10294117647058823
KC,5,2024,51,0,3,3,0.058823529411764705,2,0.0392156862745098
LA,5,2024,56,4,4,8,0.14285714285714285,3,0.05357142857142857
LV,5,2024,54,4,6,10,0.18518518518518517,5,0.09259259259259259
MIA,5,2024,54,6,4,10,0.18518518518518517,4,0.07407407407407407
MIN,5,2024,71,1,4,5,0.07042253521126761,1,0.014084507042253521
NE,5,2024,75,6,6,12,0.16,2,0.02666666666666667
NO,5,2024,77,0,8,8,0.1038961038961039,4,0.05194805194805195
NYG,5,2024,58,3,5,8,0.13793103448275862,5,0.08620689655172414
NYJ,5,2024,64,1,6,7,0.109375,6,0.09375
PIT,5,2024,75,3,7,10,0.13333333333333333,5,0.06666666666666667
SEA,5,2024,69,5,6,11,0.15942028985507245,5,0.07246376811594203
SF,5,2024,55,6,5,11,0.2,5,0.09090909090909091
TB,5,2024,79,1,14,15,0.189873417721519,8,0.10126582278481013
WAS,5,2024,59,3,4,7,0.11864406779661017,1,0.01694915254237288
ARI,6,2024,68,6,5,11,0.16176470588235295,3,0.04411764705882353
ATL,6,2024,62,4,4,8,0.12903225806451613,1,0.016129032258064516
BAL,6,2024,56,0,6,6,0.10714285714285714,5,0.08928571428571429
BUF,6,2024,59,4,8,12,0.2033898305084746,8,0.13559322033898305
CAR,6,2024,64,4,5,9,0.140625,3,0.046875
CHI,6,2024,59,2,4,6,0.1016949152542373,2,0.03389830508474576
CIN,6,2024,71,4,4,8,0.11267605633802817,0,0.0
CLE,6,2024,58,3,7,10,0.1724137931034483,5,0.08620689655172414
DAL,6,2024,64,8,10,18,0.28125,6,0.09375
DEN,6,2024,72,4,5,9,0.125,5,0.06944444444444445
DET,6,2024,65,1,6,7,0.1076923076923077,2,0.03076923076923077
GB,6,2024,55,1,4,5,0.09090909090909091,2,0.03636363636363636
HOU,6,2024,63,2,5,7,0.1111111111111111,4,0.06349206349206349
IND,6,2024,55,3,1,4,0.07272727272727272,2,0.03636363636363636
JAX,6,2024,58,7,5,12,0.20689655172413793,4,0.06896551724137931
LAC,6,2024,53,5,6,11,0.20754716981132076,6,0.11320754716981132
LV,6,2024,60,7,4,11,0.18333333333333332,4,0.06666666666666667
NE,6,2024,61,4,3,7,0.11475409836065574,6,0.09836065573770492
NO,6,2024,72,10,8,18,0.25,8,0.1111111111111111
NYG,6,2024,50,3,3,6,0.12,5,0.1
NYJ,6,2024,57,4,3,7,0.12280701754385964,2,0.03508771929824561
PHI,6,2024,53,3,2,5,0.09433962264150944,2,0.03773584905660377
PIT,6,2024,60,1,4,5,0.08333333333333333,1,0.016666666666666666
SEA,6,2024,60,4,5,9,0.15,5,0.08333333333333333
SF,6,2024,72,0,5,5,0.06944444444444445,2,0.027777777777777776
TB,6,2024,66,1,5,6,0.09090909090909091,3,0.045454545454545456
TEN,6,2024,66,2,4,6,0.09090909090909091,4,0.06060606060606061
WAS,6,2024,63,5,10,15,0.23809523809523808,7,0.1111111111111111
ARI,7,2024,63,1,8,9,0.14285714285714285,5,0.07936507936507936
ATL,7,2024,56,1,8,9,0.16071428571428573,6,0.10714285714285714
BAL,7,2024,77,3,11,14,0.18181818181818182,6,0.07792207792207792
BUF,7,2024,66,3,2,5,0.07575757575757576,2,0.030303030303030304
CAR,7,2024,61,4,8,12,0.19672131147540983,3,0.04918032786885246
CIN,7,2024,76,2,5,7,0.09210526315789473,3,0.039473684210526314
CLE,7,2024,50,3,7,10,0.2,3,0.06
DEN,7,2024,65,3,2,5,0.07692307692307693,2,0.03076923076923077
DET,7,2024,52,4,8,12,0.23076923076923078,5,0.09615384615384616
GB,7,2024,57,5,3,8,0.14035087719298245,2,0.03508771929824561
HOU,7,2024,56,3,2,5,0.08928571428571429,3,0.05357142857142857
IND,7,2024,67,6,4,10,0.14925373134328357,1,0.014925373134328358
JAX,7,2024,54,2,5,7,0.12962962962962962,3,0.05555555555555555
KC,7,2024,56,2,5,7,0.125,4,0.07142857142857142
LA,7,2024,75,3,3,6,0.08,1,0.013333333333333334
LAC,7,2024,53,8,3,11,0.20754716981132076,2,0.03773584905660377
LV,7,2024,50,3,2,5,0.1,3,0.06
MIA,7,2024,60,5,3,8,0.13333333333333333,3,0.05
MIN,7,2024,54,2,9,11,0.2037037037037037,5,0.09259259259259259
NE,7,2024,59,6,3,9,0.15254237288135594,3,0.05084745762711865
NO,7,2024,59,8,3,11,0.1864406779661017,6,0.1016949152542373
NYG,7,2024,64,7,2,9,0.140625,4,0.0625
NYJ,7,2024,66,4,7,11,0.16666666666666666,6,0.09090909090909091
PHI,7,2024,54,2,0,2,0.037037037037037035,0,0.0
PIT,7,2024,55,3,8,11,0.2,3,0.05454545454545454
SEA,7,2024,70,3,3,6,0.08571428571428572,4,0.05714285714285714
SF,7,2024,66,4,4,8,0.12121212121212122,5,0.07575757575757576
TB,7,2024,54,7,6,13,0.24074074074074073,6,0.1111111111111111
TEN,7,2024,54,3,8,11,0.2037037037037037,6,0.1111111111111111
WAS,7,2024,42,1,3,4,0.09523809523809523,2,0.047619047619047616
ARI,8,2024,64,5,5,10,0.15625,3,0.046875
ATL,8,2024,70,3,6,9,0.12857142857142856,3,0.04285714285714286
BAL,8,2024,66,1,10,11,0.16666666666666666,5,0.07575757575757576
BUF,8,2024,46,2,4,6,0.13043478260869565,1,0.021739130434782608
CAR,8,2024,71,1,9,10,0.14084507042253522,4,0.056338028169014086
CHI,8,2024,72,4,6,10,0.1388888888888889,6,0.08333333333333333
CIN,8,2024,59,5,7,12,0.2033898305084746,4,0.06779661016949153
CLE,8,2024,60,4,6,10,0.16666666666666666,8,0.13333333333333333
DAL,8,2024,63,6,6,12,0.19047619047619047,5,0.07936507936507936
DEN,8,2024,60,1,4,5,0.08333333333333333,3,0.05
DET,8,2024,71,5,6,11,0.15492957746478872,4,0.056338028169014086
GB,8,2024,56,3,10,13,0.23214285714285715,8,0.14285714285714285
HOU,8,2024,61,8,3,11,0.18032786885245902,4,0.06557377049180328
IND,8,2024,68,5,7,12,0.17647058823529413,3,0.04411764705882353
JAX,8,2024,64,3,5,8,0.125,6,0.09375
KC,8,2024,53,0,3,3,0.05660377358490566,1,0.018867924528301886
LA,8,2024,49,0,6,6,0.12244897959183673,3,0.061224489795918366
LAC,8,2024,68,3,8,11,0.16176470588235295,7,0.10294117647058823
LV,8,2024,64,1,6,7,0.109375,2,0.03125
MIA,8,2024,61,3,9,12,0.19672131147540983,4,0.06557377049180328
MIN,8,2024,63,4,8,12,0.19047619047619047,3,0.047619047619047616
NE,8,2024,57,2,8,10,0.17543859649122806,5,0.08771929824561403
NO,8,2024,63,2,8,10,0.15873015873015872,5,0.07936507936507936
NYG,8,2024,61,6,4,10,0.16393442622950818,5,0.08196721311475409
NYJ,8,2024,63,4,1,5,0.07936507936507936,1,0.015873015873015872
PHI,8,2024,57,0,3,3,0.05263157894736842,3,0.05263157894736842
PIT,8,2024,67,4,6,10,0.14925373134328357,5,0.07462686567164178
SEA,8,2024,66,5,7,12,0.18181818181818182,5,0.07575757575757576
SF,8,2024,58,2,7,9,0.15517241379310345,4,0.06896551724137931
TB,8,2024,60,3,5,8,0.13333333333333333,5,0.08333333333333333
TEN,8,2024,47,2,1,3,0.06382978723404255,2,0.0425531914893617
WAS,8,2024,60,4,5,9,0.15,4,0.06666666666666667
ARI,9,2024,69,2,5,7,0.10144927536231885,1,0.014492753623188406
ATL,9,2024,73,5,4,9,0.1232876712328767,3,0.0410958904109589
BAL,9,2024,67,3,6,9,0.13432835820895522,5,0.07462686567164178
BUF,9,2024,59,4,7,11,0.1864406779661017,2,0.03389830508474576
CAR,9,2024,74,4,9,13,0.17567567567567569,4,0.05405405405405406
CHI,9,2024,57,5,5,10,0.17543859649122806,3,0.05263157894736842
CIN,9,2024,59,0,6,6,0.1016949152542373,4,0.06779661016949153
CLE,9,2024,54,3,8,11,0.2037037037037037,7,0.12962962962962962
DAL,9,2024,53,2,5,7,0.1320754716981132,3,0.05660377358490566
DEN,9,2024,53,3,9,12,0.22641509433962265,7,0.1320754716981132
DET,9,2024,62,4,5,9,0.14516129032258066,4,0.06451612903225806
GB,9,2024,52,4,2,6,0.11538461538461539,1,0.019230769230769232
HOU,9,2024,54,4,4,8,0.14814814814814814,3,0.05555555555555555
IND,9,2024,70,6,8,14,0.2,7,0.1
JAX,9,2024,70,8,6,14,0.2,7,0.1
KC,9,2024,52,2,4,6,0.11538461538461539,0,0.0
LA,9,2024,73,2,11,13,0.1780821917808219,9,0.1232876712328767
LAC,9,2024,76,2,3,5,0.06578947368421052,1,0.013157894736842105
LV,9,2024,69,3,4,7,0.10144927536231885,3,0.043478260869565216
MIA,9,2024,58,3,3,6,0.10344827586206896,2,0.034482758620689655
MIN,9,2024,48,2,5,7,0.14583333333333334,2,0.041666666666666664
NE,9,2024,73,5,4,9,0.1232876712328767,4,0.0547945205479452
NO,9,2024,48,2,6,8,0.16666666666666666,3,0.0625
NYG,9,2024,57,3,6,9,0.15789473684210525,5,0.08771929824561403
NYJ,9,2024,74,5,4,9,0.12162162162162163,5,0.06756756756756757
PHI,9,2024,50,2,5,7,0.14,2,0.04
SEA,9,2024,68,0,8,8,0.11764705882352941,5,0.07352941176470588
TB,9,2024,83,3,6,9,0.10843373493975904,2,0.024096385542168676
TEN,9,2024,64,5,1,6,0.09375,3,0.046875
WAS,9,2024,59,7,5,12,0.2033898305084746,3,0.05084745762711865
ARI,10,2024,55,2,1,3,0.05454545454545454,0,0.0
ATL,10,2024,51,2,6,8,0.1568627450980392,5,0.09803921568627451
BAL,10,2024,75,0,9,9,0.12,4,0.05333333333333334
BUF,10,2024,61,3,6,9,0.14754098360655737,5,0.08196721311475409
CAR,10,2024,71,5,3,8,0.11267605633802817,2,0.028169014084507043
CHI,10,2024,60,3,5,8,0.13333333333333333,3,0.05
CIN,10,2024,57,2,6,8,0.14035087719298245,2,0.03508771929824561
DAL,10,2024,64,5,4,9,0.140625,4,0.0625
DEN,10,2024,65,2,5,7,0.1076923076923077,4,0.06153846153846154
DET,10,2024,65,1,7,8,0.12307692307692308,3,0.046153846153846156
HOU,10,2024,62,4,7,11,0.1774193548387097,6,0.0967741935483871
IND,10,2024,69,4,7,11,0.15942028985507245,5,0.07246376811594203
JAX,10,2024,80,4,4,8,0.1,3,0.0375
KC,10,2024,55,2,3,5,0.09090909090909091,3,0.05454545454545454
LA,10,2024,52,2,5,7,0.1346153846153846,3,0.057692307692307696
LAC,10,2024,51,4,5,9,0.17647058823529413,1,0.0196078431372549
MIA,10,2024,67,0,7,7,0.1044776119402985,2,0.029850746268656716
MIN,10,2024,43,2,3,5,0.11627906976744186,1,0.023255813953488372
NE,10,2024,59,1,1,2,0.03389830508474576,0,0.0
NO,10,2024,73,2,10,12,0.1643835616438356,7,0.0958904109589041
NYG,10,2024,58,5,2,7,0.1206896551724138,6,0.10344827586206896
NYJ,10,2024,56,6,7,13,0.23214285714285715,2,0.03571428571428571
PHI,10,2024,56,2,0,2,0.03571428571428571,0,0.0
PIT,10,2024,59,1,4,5,0.0847457627118644,3,0.05084745762711865
SF,10,2024,58,3,1,4,0.06896551724137931,0,0.0
TB,10,2024,59,3,6,9,0.15254237288135594,5,0.0847457627118644
TEN,10,2024,55,5,5,10,0.18181818181818182,2,0.03636363636363636
WAS,10,2024,72,3,5,8,0.1111111111111111,4,0.05555555555555555
ATL,11,2024,60,3,6,9,0.15,4,0.06666666666666667
BAL,11,2024,72,3,5,8,0.1111111111111111,3,0.041666666666666664
BUF,11,2024,52,1,2,3,0.057692307692307696,1,0.019230769230769232
CHI,11,2024,42,4,8,12,0.2857142857142857,5,0.11904761904761904
CIN,11,2024,62,4,10,14,0.22580645161290322,11,0.1774193548387097
CLE,11,2024,56,6,7,13,0.23214285714285715,5,0.08928571428571429
DAL,11,2024,60,3,4,7,0.11666666666666667,5,0.08333333333333333
DEN,11,2024,55,0,7,7,0.12727272727272726,2,0.03636363636363636
DET,11,2024,47,0,3,3,0.06382978723404255,3,0.06382978723404255
GB,11,2024,68,5,5,10,0.14705882352941177,3,0.04411764705882353
HOU,11,2024,79,1,7,8,0.10126582278481013,3,0.0379746835443038
IND,11,2024,52,2,5,7,0.1346153846153846,3,0.057692307692307696
JAX,11,2024,74,4,11,15,0.20270270270270271,11,0.14864864864864866
KC,11,2024,69,1,8,9,0.13043478260869565,6,0.08695652173913043
LA,11,2024,72,3,6,9,0.125,2,0.027777777777777776
LAC,11,2024,78,3,8,11,0.14102564102564102,8,0.10256410256410256
LV,11,2024,63,1,7,8,0.12698412698412698,3,0.047619047619047616
MIA,11,2024,62,1,3,4,0.06451612903225806,4,0.06451612903225806
MIN,11,2024,55,1,7,8,0.14545454545454545,4,0.07272727272727272
NE,11,2024,48,3,7,10,0.20833333333333334,5,0.10416666666666667
NO,11,2024,69,1,8,9,0.13043478260869565,5,0.07246376811594203
NYJ,11,2024,67,1,9,10,0.14925373134328357,4,0.05970149253731343
PHI,11,2024,63,1,4,5,0.07936507936507936,2,0.031746031746031744
PIT,11,2024,53,3,6,9,0.16981132075471697,5,0.09433962264150944
SEA,11,2024,57,4,1,5,0.08771929824561403,1,0.017543859649122806
SF,11,2024,59,3,5,8,0.13559322033898305,2,0.03389830508474576
TEN,11,2024,66,1,6,7,0.10606060606060606,4,0.06060606060606061
WAS,11,2024,69,4,6,10,0.14492753623188406,6,0.08695652173913043
ARI,12,2024,59,2,6,8,0.13559322033898305,3,0.05084745762711865
BAL,12,2024,60,3,6,9,0.15,0,0.0
CAR,12,2024,68,5,5,10,0.14705882352941177,3,0.04411764705882353
CHI,12,2024,65,4,6,10,0.15384615384615385,7,0.1076923076923077
CLE,12,2024,67,4,6,10,0.14925373134328357,6,0.08955223880597014
DAL,12,2024,66,5,3,8,0.12121212121212122,3,0.045454545454545456
DEN,12,2024,73,2,7,9,0.1232876712328767,3,0.0410958904109589
DET,12,2024,48,4,4,8,0.16666666666666666,4,0.08333333333333333
GB,12,2024,46,1,5,6,0.13043478260869565,5,0.10869565217391304
HOU,12,2024,64,5,5,10,0.15625,4,0.0625
IND,12,2024,71,4,7,11,0.15492957746478872,2,0.028169014084507043
KC,12,2024,58,2,6,8,0.13793103448275862,4,0.06896551724137931
LA,12,2024,66,5,5,10,0.15151515151515152,5,0.07575757575757576
LAC,12,2024,58,6,5,11,0.1896551724137931,5,0.08620689655172414
LV,12,2024,65,2,8,10,0.15384615384615385,4,0.06153846153846154
MIA,12,2024,62,2,4,6,0.0967741935483871,3,0.04838709677419355
MIN,12,2024,72,2,6,8,0.1111111111111111,6,0.08333333333333333
NE,12,2024,63,2,7,9,0.14285714285714285,4,0.06349206349206349
NYG,12,2024,62,3,7,10,0.16129032258064516,6,0.0967741935483871
PHI,12,2024,59,4,4,8,0.13559322033898305,3,0.05084745762711865
PIT,12,2024,55,0,7,7,0.12727272727272726,3,0.05454545454545454
SEA,12,2024,56,1,6,7,0.125,4,0.07142857142857142
SF,12,2024,67,4,5,9,0.13432835820895522,2,0.029850746268656716
TB,12,2024,55,2,3,5,0.09090909090909091,2,0.03636363636363636
TEN,12,2024,54,0,8,8,0.14814814814814814,3,0.05555555555555555
WAS,12,2024,61,0,5,5,0.08196721311475409,3,0.04918032786885246
ARI,13,2024,50,2,7,9,0.18,3,0.06
ATL,13,2024,43,2,2,4,0.09302325581395349,2,0.046511627906976744
BAL,13,2024,52,4,3,7,0.1346153846153846,1,0.019230769230769232
BUF,13,2024,46,7,2,9,0.1956521739130435,2,0.043478260869565216
CAR,13,2024,76,7,7,14,0.18421052631578946,6,0.07894736842105263
CHI,13,2024,69,7,5,12,0.17391304347826086,3,0.043478260869565216
CIN,13,2024,64,3,12,15,0.234375,10,0.15625
CLE,13,2024,59,3,8,11,0.1864406779661017,3,0.05084745762711865
DAL,13,2024,59,2,5,7,0.11864406779661017,2,0.03389830508474576
DEN,13,2024,84,2,11,13,0.15476190476190477,6,0.07142857142857142
DET,13,2024,58,3,6,9,0.15517241379310345,4,0.06896551724137931
GB,13,2024,65,2,6,8,0.12307692307692308,2,0.03076923076923077
HOU,13,2024,67,2,7,9,0.13432835820895522,4,0.05970149253731343
IND,13,2024,65,6,4,10,0.15384615384615385,3,0.046153846153846156
JAX,13,2024,58,4,6,10,0.1724137931034483,5,0.08620689655172414
KC,13,2024,62,4,7,11,0.1774193548387097,7,0.11290322580645161
LA,13,2024,68,4,5,9,0.1323529411764706,3,0.04411764705882353
LAC,13,2024,77,2,3,5,0.06493506493506493,2,0.025974025974025976
LV,13,2024,65,1,8,9,0.13846153846153847,6,0.09230769230769231
MIA,13,2024,53,4,7,11,0.20754716981132076,4,0.07547169811320754
MIN,13,2024,76,5,4,9,0.11842105263157894,1,0.013157894736842105
NE,13,2024,57,3,1,4,0.07017543859649122,1,0.017543859649122806
NO,13,2024,53,6,5,11,0.20754716981132076,2,0.03773584905660377
NYG,13,2024,66,4,5,9,0.13636363636363635,4,0.06060606060606061
NYJ,13,2024,56,3,5,8,0.14285714285714285,5,0.08928571428571429
PHI,13,2024,71,5,5,10,0.14084507042253522,4,0.056338028169014086
PIT,13,2024,57,3,8,11,0.19298245614035087,5,0.08771929824561403
SEA,13,2024,61,2,4,6,0.09836065573770492,2,0.03278688524590164
SF,13,2024,53,5,3,8,0.1509433962264151,2,0.03773584905660377
TB,13,2024,68,1,7,8,0.11764705882352941,3,0.04411764705882353
TEN,13,2024,76,7,3,10,0.13157894736842105,3,0.039473684210526314
WAS,13,2024,50,0,7,7,0.14,3,0.06
ARI,14,2024,61,5,6,11,0.18032786885245902,4,0.06557377049180328
ATL,14,2024,53,5,9,14,0.2641509433962264,7,0.1320754716981132
BUF,14,2024,72,3,10,13,0.18055555555555555,4,0.05555555555555555
CAR,14,2024,55,8,2,10,0.18181818181818182,3,0.05454545454545454
CHI,14,2024,60,1,10,11,0.18333333333333332,9,0.15
CIN,14,2024,59,6,4,10,0.1694915254237288,3,0.05084745762711865
CLE,14,2024,60,3,4,7,0.11666666666666667,5,0.08333333333333333
DAL,14,2024,63,2,8,10,0.15873015873015872,3,0.047619047619047616
DET,14,2024,44,2,5,7,0.1590909090909091,5,0.11363636363636363
GB,14,2024,76,3,5,8,0.10526315789473684,3,0.039473684210526314
JAX,14,2024,62,3,4,7,0.11290322580645161,3,0.04838709677419355
KC,14,2024,57,2,7,9,0.15789473684210525,5,0.08771929824561403
LA,14,2024,54,3,9,12,0.2222222222222222,8,0.14814814814814814
LAC,14,2024,63,1,2,3,0.047619047619047616,1,0.015873015873015872
LV,14,2024,59,5,10,15,0.2542372881355932,6,0.1016949152542373
MIA,14,2024,63,1,8,9,0.14285714285714285,3,0.047619047619047616
MIN,14,2024,70,4,9,13,0.18571428571428572,6,0.08571428571428572
NO,14,2024,73,3,5,8,0.1095890410958904,4,0.0547945205479452
NYG,14,2024,65,2,5,7,0.1076923076923077,3,0.046153846153846156
NYJ,14,2024,65,0,6,6,0.09230769230769231,3,0.046153846153846156
PHI,14,2024,68,2,4,6,0.08823529411764706,2,0.029411764705882353
PIT,14,2024,69,3,3,6,0.08695652173913043,2,0.028985507246376812
SEA,14,2024,62,6,3,9,0.14516129032258066,2,0.03225806451612903
SF,14,2024,52,1,1,2,0.038461538461538464,0,0.0
TB,14,2024,63,2,3,5,0.07936507936507936,4,0.06349206349206349
TEN,14,2024,57,2,5,7,0.12280701754385964,4,0.07017543859649122
ARI,15,2024,49,5,6,11,0.22448979591836735,4,0.08163265306122448
ATL,15,2024,64,2,4,6,0.09375,3,0.046875
BAL,15,2024,59,1,5,6,0.1016949152542373,2,0.03389830508474576
BUF,15,2024,75,2,10,12,0.16,6,0.08
CAR,15,2024,68,7,6,13,0.19117647058823528,2,0.029411764705882353
CHI,15,2024,71,3,5,8,0.11267605633802817,1,0.014084507042253521
CIN,15,2024,64,3,5,8,0.125,3,0.046875
CLE,15,2024,73,5,3,8,0.1095890410958904,2,0.0273972602739726
DAL,15,2024,50,1,5,6,0.12,1,0.02
DEN,15,2024,72,5,6,11,0.1527777777777778,4,0.05555555555555555
DET,15,2024,67,5,10,15,0.22388059701492538,9,0.13432835820895522
GB,15,2024,56,2,4,6,0.10714285714285714,3,0.05357142857142857
HOU,15,2024,62,0,3,3,0.04838709677419355,2,0.03225806451612903
IND,15,2024,58,2,2,4,0.06896551724137931,1,0.017241379310344827
JAX,15,2024,53,5,7,12,0.22641509433962265,6,0.11320754716981132
KC,15,2024,59,1,3,4,0.06779661016949153,3,0.05084745762711865
LA,15,2024,53,2,3,5,0.09433962264150944,1,0.018867924528301886
LAC,15,2024,67,4,7,11,0.16417910447761194,7,0.1044776119402985
LV,15,2024,57,4,2,6,0.10526315789473684,2,0.03508771929824561
MIA,15,2024,47,2,2,4,0.0851063829787234,1,0.02127659574468085
MIN,15,2024,62,2,4,6,0.0967741935483871,3,0.04838709677419355
NE,15,2024,63,2,4,6,0.09523809523809523,5,0.07936507936507936
NO,15,2024,74,3,4,7,0.0945945945945946,3,0.04054054054054054
NYG,15,2024,58,6,7,13,0.22413793103448276,6,0.10344827586206896
NYJ,15,2024,77,3,5,8,0.1038961038961039,3,0.03896103896103896
PHI,15,2024,41,0,3,3,0.07317073170731707,1,0.024390243902439025
PIT,15,2024,74,2,10,12,0.16216216216216217,8,0.10810810810810811
SEA,15,2024,61,2,4,6,0.09836065573770492,4,0.06557377049180328
SF,15,2024,65,2,1,3,0.046153846153846156,1,0.015384615384615385
TB,15,2024,48,0,2,2,0.041666666666666664,2,0.041666666666666664
TEN,15,2024,63,3,6,9,0.14285714285714285,3,0.047619047619047616
WAS,15,2024,50,3,5,8,0.16,4,0.08
ARI,16,2024,64,6,5,11,0.171875,7,0.109375
ATL,16,2024,55,0,5,5,0.09090909090909091,2,0.03636363636363636
BAL,16,2024,59,3,4,7,0.11864406779661017,2,0.03389830508474576
BUF,16,2024,68,4,4,8,0.11764705882352941,4,0.058823529411764705
CAR,16,2024,64,5,4,9,0.140625,4,0.0625
CHI,16,2024,64,4,8,12,0.1875,5,0.078125
CIN,16,2024,63,4,3,7,0.1111111111111111,2,0.031746031746031744
CLE,16,2024,55,3,6,9,0.16363636363636364,5,0.09090909090909091
DAL,16,2024,70,5,7,12,0.17142857142857143,3,0.04285714285714286
DEN,16,2024,58,4,7,11,0.1896551724137931,5,0.08620689655172414
DET,16,2024,59,2,9,11,0.1864406779661017,5,0.0847457627118644
GB,16,2024,53,1,4,5,0.09433962264150944,2,0.03773584905660377
HOU,16,2024,68,3,6,9,0.1323529411764706,3,0.04411764705882353
IND,16,2024,56,2,6,8,0.14285714285714285,3,0.05357142857142857
JAX,16,2024,64,2,5,7,0.109375,3,0.046875
KC,16,2024,58,4,7,11,0.1896551724137931,5,0.08620689655172414
LA,16,2024,63,0,4,4,0.06349206349206349,1,0.015873015873015872
LAC,16,2024,63,3,4,7,0.1111111111111111,1,0.015873015873015872
LV,16,2024,61,3,4,7,0.11475409836065574,2,0.03278688524590164
MIA,16,2024,59,2,9,11,0.1864406779661017,5,0.0847457627118644
MIN,16,2024,60,1,11,12,0.2,3,0.05
NE,16,2024,58,4,3,7,0.1206896551724138,2,0.034482758620689655
NO,16,2024,67,5,5,10,0.14925373134328357,5,0.07462686567164178
NYG,16,2024,63,4,6,10,0.15873015873015872,1,0.015873015873015872
NYJ,16,2024,47,2,2,4,0.0851063829787234,1,0.02127659574468085
PHI,16,2024,63,3,3,6,0.09523809523809523,4,0.06349206349206349
PIT,16,2024,59,8,4,12,0.2033898305084746,3,0.05084745762711865
SEA,16,2024,59,1,5,6,0.1016949152542373,2,0.03389830508474576
SF,16,2024,63,2,4,6,0.09523809523809523,5,0.07936507936507936
TB,16,2024,53,1,5,6,0.11320754716981132,5,0.09433962264150944
TEN,16,2024,62,3,4,7,0.11290322580645161,6,0.0967741935483871
WAS,16,2024,71,6,2,8,0.11267605633802817,3,0.04225352112676056
ARI,17,2024,53,3,6,9,0.16981132075471697,3,0.05660377358490566
ATL,17,2024,76,8,2,10,0.13157894736842105,2,0.02631578947368421
BAL,17,2024,54,0,5,5,0.09259259259259259,1,0.018518518518518517
BUF,17,2024,57,6,3,9,0.15789473684210525,3,0.05263157894736842
CAR,17,2024,71,6,12,18,0.2535211267605634,7,0.09859154929577464
CHI,17,2024,50,3,4,7,0.14,2,0.04
CIN,17,2024,60,4,4,8,0.13333333333333333,2,0.03333333333333333
CLE,17,2024,55,3,3,6,0.10909090909090909,1,0.01818181818181818
DAL,17,2024,59,4,5,9,0.15254237288135594,7,0.11864406779661017
DEN,17,2024,83,2,8,10,0.12048192771084337,3,0.03614457831325301
DET,17,2024,59,1,9,10,0.1694915254237288,5,0.0847457627118644
GB,17,2024,67,2,8,10,0.14925373134328357,5,0.07462686567164178
HOU,17,2024,61,5,4,9,0.14754098360655737,6,0.09836065573770492
IND,17,2024,49,2,8,10,0.20408163265306123,6,0.12244897959183673
JAX,17,2024,64,5,5,10,0.15625,3,0.046875
KC,17,2024,73,9,4,13,0.1780821917808219,4,0.0547945205479452
LA,17,2024,74,3,7,10,0.13513513513513514,4,0.05405405405405406
LAC,17,2024,48,3,2,5,0.10416666666666667,2,0.041666666666666664
LV,17,2024,53,2,6,8,0.1509433962264151,4,0.07547169811320754
MIA,17,2024,76,2,4,6,0.07894736842105263,0,0.0
MIN,17,2024,57,2,4,6,0.10526315789473684,1,0.017543859649122806
NE,17,2024,77,1,6,7,0.09090909090909091,2,0.025974025974025976
NO,17,2024,72,4,6,10,0.1388888888888889,2,0.027777777777777776
NYG,17,2024,73,2,6,8,0.1095890410958904,5,0.0684931506849315
NYJ,17,2024,60,1,4,5,0.08333333333333333,3,0.05
PHI,17,2024,60,3,4,7,0.11666666666666667,1,0.016666666666666666
PIT,17,2024,58,1,6,7,0.1206896551724138,3,0.05172413793103448
SEA,17,2024,58,3,4,7,0.1206896551724138,1,0.017241379310344827
SF,17,2024,66,3,6,9,0.13636363636363635,6,0.09090909090909091
TB,17,2024,46,0,7,7,0.15217391304347827,3,0.06521739130434782
TEN,17,2024,56,2,4,6,0.10714285714285714,3,0.05357142857142857
WAS,17,2024,60,4,4,8,0.13333333333333333,3,0.05
ARI,18,2024,71,3,6,9,0.1267605633802817,6,0.08450704225352113
ATL,18,2024,64,5,6,11,0.171875,4,0.0625
BAL,18,2024,54,1,5,6,0.1111111111111111,3,0.05555555555555555
BUF,18,2024,58,1,4,5,0.08620689655172414,2,0.034482758620689655
CAR,18,2024,77,8,8,16,0.2077922077922078,8,0.1038961038961039
CHI,18,2024,61,6,7,13,0.21311475409836064,5,0.08196721311475409
CIN,18,2024,58,3,3,6,0.10344827586206896,1,0.017241379310344827
CLE,18,2024,66,7,5,12,0.18181818181818182,6,0.09090909090909091
DAL,18,2024,53,3,2,5,0.09433962264150944,3,0.05660377358490566
DEN,18,2024,33,0,3,3,0.09090909090909091,2,0.06060606060606061
DET,18,2024,61,1,4,5,0.08196721311475409,3,0.04918032786885246
GB,18,2024,56,1,4,5,0.08928571428571429,1,0.017857142857142856
HOU,18,2024,60,1,7,8,0.13333333333333333,3,0.05
IND,18,2024,66,4,4,8,0.12121212121212122,4,0.06060606060606061
JAX,18,2024,77,3,6,9,0.11688311688311688,3,0.03896103896103896
KC,18,2024,71,3,6,9,0.1267605633802817,6,0.08450704225352113
LA,18,2024,52,4,6,10,0.19230769230769232,4,0.07692307692307693
LAC,18,2024,47,1,6,7,0.14893617021276595,5,0.10638297872340426
LV,18,2024,70,4,8,12,0.17142857142857143,5,0.07142857142857142
MIA,18,2024,62,5,6,11,0.1774193548387097,5,0.08064516129032258
MIN,18,2024,66,5,3,8,0.12121212121212122,3,0.045454545454545456
NE,18,2024,65,2,1,3,0.046153846153846156,2,0.03076923076923077
NO,18,2024,63,6,4,10,0.15873015873015872,5,0.07936507936507936
NYG,18,2024,67,0,5,5,0.07462686567164178,0,0.0
NYJ,18,2024,68,4,5,9,0.1323529411764706,4,0.058823529411764705
PHI,18,2024,54,2,2,4,0.07407407407407407,1,0.018518518518518517
PIT,18,2024,70,0,5,5,0.07142857142857142,0,0.0
SEA,18,2024,65,0,8,8,0.12307692307692308,6,0.09230769230769231
SF,18,2024,62,2,4,6,0.0967741935483871,6,0.0967741935483871
TB,18,2024,63,2,4,6,0.09523809523809523,2,0.031746031746031744
TEN,18,2024,57,5,4,9,0.15789473684210525,3,0.05263157894736842
WAS,18,2024,75,3,5,8,0.10666666666666667,4,0.05333333333333334
BAL,19,2024,44,0,6,6,0.13636363636363635,6,0.13636363636363635
BUF,19,2024,42,3,4,7,0.16666666666666666,2,0.047619047619047616
DEN,19,2024,69,4,6,10,0.14492753623188406,4,0.057971014492753624
GB,19,2024,56,4,2,6,0.10714285714285714,2,0.03571428571428571
HOU,19,2024,54,0,6,6,0.1111111111111111,1,0.018518518518518517
LA,19,2024,70,3,6,9,0.12857142857142856,4,0.05714285714285714
LAC,19,2024,68,5,3,8,0.11764705882352941,4,0.058823529411764705
MIN,19,2024,49,2,4,6,0.12244897959183673,4,0.08163265306122448
PHI,19,2024,59,2,5,7,0.11864406779661017,4,0.06779661016949153
PIT,19,2024,70,6,6,12,0.17142857142857143,7,0.1
TB,19,2024,67,1,7,8,0.11940298507462686,4,0.05970149253731343
WAS,19,2024,44,3,6,9,0.20454545454545456,4,0.09090909090909091
BAL,20,2024,57,3,1,4,0.07017543859649122,1,0.017543859649122806
BUF,20,2024,56,9,8,17,0.30357142857142855,5,0.08928571428571429
DET,20,2024,71,6,5,11,0.15492957746478872,6,0.08450704225352113
HOU,20,2024,47,4,4,8,0.1702127659574468,3,0.06382978723404255
KC,20,2024,64,3,6,9,0.140625,4,0.0625
LA,20,2024,60,5,2,7,0.11666666666666667,4,0.06666666666666667
PHI,20,2024,70,2,8,10,0.14285714285714285,7,0.1
WAS,20,2024,65,7,8,15,0.23076923076923078,7,0.1076923076923077
BUF,21,2024,60,5,6,11,0.18333333333333332,4,0.06666666666666667
KC,21,2024,68,3,5,8,0.11764705882352941,5,0.07352941176470588
PHI,21,2024,77,2,5,7,0.09090909090909091,4,0.05194805194805195
WAS,21,2024,64,5,7,12,0.1875,6,0.09375
KC,22,2024,67,4,6,10,0.14925373134328357,5,0.07462686567164178
PHI,22,2024,49,0,3,3,0.061224489795918366,3,0.061224489795918366
